# # # # # # # # # # # # # # #
# E O O O O O O O O O O O E #
# O # O # # # # # # # O # O #
# O # O O O O O O O O O # O #
# O # O # # # O # # # O # O #
# O # O O O # O # O O O # O #
# O # # # O # O # O # # # O #
T O # # # O # X # O # # # O T
# O O O O O # # # O O O O O #
# O # # # O # # # O # # # O #
# O # # # O O O O O # # # O #
# O # O O O # # # O O O # O #
# O # O # # # # # # # O # O #
# O O O O O O P O O O O O O #
# # # # # # # # # # # # # # #