#############################
####     #                ###
#P   ###   ######### #### ###
#### #########K##### #### ###
##         ### ##### #### ###
###  ####  ###            ###
###  ####  ############## ###
####         ############ ###
###  ######  ############ ###
#    ######  ###    ##### ###
###                       ###
#######   ##  ####### #######
#####################D#######
